111111111111111111111111111111111111111111111111111111111111111111111111111111111111111111111111
111111111111111111111111111111111111111111111111111111111111111111111111111111111111111111111111
111111111111111111111111111111111111111111111111111111111111111111111111111111111111111111111111
111111111111111111111111111111111111111111111111111111111111111111111111111111111111111111111111
111111111111111111111111111111111111111111111111111111111111111111111111111111111111111111111111
111111111111111111111111111111111111111111111111111111111111111111111111111111111111111111111111
111111111111111111111111111111111111111111111111111111111111111111111111111111111111111111111111
111111111111111111111111111111111111111111111111111111111111111111111111111111111111111111111111
111111111111111111111111111111111111111111111111111111111111111111111111111111111111111111111111
111111111111111111111111111111111111111111111111111111111111111111111111111111111111111111111111
111111111111111111111111111111111111111111111111111111111111111111111111111111111111111111111111
111111111111111111111111111111111111111111111111111111111111111111111111111111111111111111111111
111111111111111111111111111111111111111111111111111111111111111111111111111111111111111111111111
111111111111111111111111111111111111111111111111111111111111111111111111111111111111111111111111
111111111111111111111111111111111111111111111111111111111111111111111111111111111111111111111111
111111111111111111111111111111111111111111111111111111111111111111111111111111111111111111111111
111111111111111111111111111111111111111111111111111111111111111111111111111111111111111111111111
111111111111111111111111111111111111111111111111111111111111111111111111111111111111111111111111
111111111111111111111111111111111111111111111111111111111111111111111111111111111111111111111111
111111111111111111111111111111111111111111111111111111111111111111111111111111111111111111111111
111111111111111111111111111111111111111111111111111111111111111111111111111111111111111111111111
111111111111111111111111111111111111111111111111111111111111111111111111111111111111111111111111
111111111111111111111111111111111111111111111111111111111111111111111111111111111111111111111111
111111111111111111111111111111111111111111111111111111111111111111111111111111111111111111111111
111111111111111111111111111111111111111111111111111111111111111111111111111111111111111111111111
111111111111111111111111111111111111111111111111111111111111111111111111111111111111111111111111
111111111111111111111111111111111111111111111111111111111111111111111111111111111111111111111111
111111111111111111111111111111111111111111111111111111111111111111111111111111111111111111111111
111111111111111111111111111111111111111111111111111111111111111111111111111111111111111111111111
111111111111111111111111111111111111111111111111111111111111111111111111111111111111111111111111
111111111111111111111111111111111111111111111111111111111111111111111111111111111111111111111111
111111111111111111111111111111111111111111111111111111111111111111111111111111111111111111111111
111111111111111111111111111111111111111111111111111111111111111111111111111111111111111111111111
111111111111111111111111111111111111111111111111111111111111111111111111111111111111111111111111
111111111111111111111111111111111111111111111111111111111111111111111111111111111111111111111111
111111111111111111111111111111111111111111111111111111111111111111111111111111111111111111111111
111111111111111111111111111111111111111111111111111111111111111111111111111111111111111111111111
111111111111111111111111111111111111111111111111111111111111111111111111111111111111111111111111
111111111111111111111111111111111111111111111111111111111111111111111111111111111111111111111111
111111111111111111111111111111111111111111111111111111111111111111111111111111111111111111111111
111111111111111111111111111111111111111111111111111111111111111111111111111111111111111111111111
111111111111111111111111111111111111111111111111111111111111111111111111111111111111111111111111
111111111111111111111111111111111111111111111111111111111111111111111111111111111111111111111111
111111111111111111111111111111111111111111111111111111111111111111111111111111111111111111111111
111111111111111111111111111111111111111111111111111111111111111111111111111111111111111111111111
111111111111111111111111111111111111111111111111111111111111111111111111111111111111111111111111
111111111111111111111111111111111111111111111111111111111111111111111111111111111111111111111111
111111111111111111111111111111111111111111111111111111111111111111111111111111111111111111111111
111111111111111111111111111111111111111111111111111111111111111111111111111111111111111111111111
111111111111111111111111111111111111111111111111111111111111111111111111111111111111111111111111
111111111111111111111111111111111111111111111111111111111111111111111111111111111111111111111111
111111111111001111111111111111111111111111111111111111111111111111111111111111111111111111111111
111111111000001111111111111111111111111111111111111111111111111111111111111111111111111111111111
111111110000001111111111111111111111111111111111111111111111111111111111111111111111111111111111
111111100000000111111111111111111111111111111111111111111111111111111111111111111111111111111111
111111000000000111111111111111111111111111111111111111111111111111111111111111111111111111111111
111110000000000111111111111111111111111111111111111111111111111111111111111111111111111111111111
111100000000000111111111111111111111111111111111111111111111111111111111111111111111111111111111
111000000000000111111111111111111111111111111111111111111111111111111111111111111111111111111111
110000000000000111111111111111111000011111111111111111111111111111111111111111111111111111111111
110000000000000111111111111111000000011111111111111111111111111111111111111111111111111111111111
110000000000000111111111111111000000011111111111111111111111111111111111111111111111111111111111
100000000000000011111111111111000000001111111111111111111111111111111111111111111111111111111111
100000000000000111111111111111111111111111111111111111111111111111111111111111111111111111111111
100000000000000000000000100000000100000000111111111111111111111111111111111111111111111111111111
100000000000000-100000000100000000100000000111111111111111111111111111111111111111111111111111111
100000000000000000000000100000000100000000111111111111111111111111111111111111111111111111111111
100000000000000111110000111110000100000000111111111111111111111111111111111111111111111111111111
100000000000000100010000000000000000010001111111111111111111111111111111111111111111111111111111
110000000000000100010000000000000000010000111111111111111111111111111111111111111111111111111111
110000000000000100010000000000000000010001100111111111111111111111111111111111111111111111111111
110000000000000100010000000000000000010001100001111111111111111111111111111111111111111111111111
111000000000000100001111000001111111110001110000011111111111111111111111111111111111111111111111
111100000000001100000000000000000100000000111100001111111111111111111111111111111111111111111111
111110000000001100000000000000000100000000111110011111111111111111111111111111111111111111111111
111111000000000100000000000000000100000000111111111111111111111111111111111111111111111111111111
111111100000000111111111111111111100011111111111111111111111111111111111111111111111111111111111
111111110000000100000000000010000000010000111111111111111111111111111111111111111111111111111111
111111111000000100000000000010000000010000111111111111111111111111111111111111111111111111111111
111111111111000100000000000010000000010000111111111111111111111111111111111111111111111111111111
111111111111100100000000000010000000010000011111111111111111111111111111111111111111111111111111
111111111111110100011111000000001111110011111111111111111111111111111111111111111111111111111111
111111111111111100010000000000001111111111111111111111111111111111111111111111111111111111111111
111111111111111100010000000000001011111111111111111111111111111111111111111111111111111111111111
111111111111111100010000000000001011111111111111111111111111111111111111111111111111111111111111
111111111111111100011111000000001011111111111111111111111111111111111111111111111111111111111111
111111111111111100000001100000000011111111111111111111111111111111111111111111111111111111111111
111111111111111100000001100000000001111111111111111111111111111111111111111111111111111111111111
111111111111111100000001100010000000111111111111111111111111111111111111111111111111111111111111
111111111111111111100001000010000000011111111111111111111111111111111111111111111111111111111111
111111111111111111100001111111111111111111111111111111111111111111111111111111111111111111111111
11111111111111111110-2000000000001111111111111111111111111111111111111111111111111111111111111111
111111111111111111110000000000000111111111111111111111111111111111111111111111111111111111111111
111111111111111111110000000000000111111111111111111111111111111111111111111111111111111111111111
111111111111111111110000000000000111111111111111111111111111111111111111111111111111111111111111
111111111111111111110000000000001111111111111111111111111111111111111111111111111111111111111111
111111111111111111110000000000011111111111111111111111111111111111111111111111111111111111111111
111111111111111111111000000000011111111111111111111111111111111111111111111111111111111111111111
111111111111111111111000000000111111111111111111111111111111111111111111111111111111111111111111
111111111111111111111000000001111111111111111111111111111111111111111111111111111111111111111111
111111111111111111111000000111111111111111111111111111111111111111111111111111111111111111111111
111111111111111111111100001111111111111111111111111111111111111111111111111111111111111111111111
111111111111111111111100011111111111111111111111111111111111111111111111111111111111111111111111
111111111111111111111111111111111111111111111111111111111111111111111111111111111111111111111111
111111111111111111111111111111111111111111111111111111111111111111111111111111111111111111111111
111111111111111111111111111111111111111111111111111111111111111111111111111111111111111111111111
111111111111111111111111111111111111111111111111111111111111111111111111111111111111111111111111
111111111111111111111111111111111111111111111111111111111111111111111111111111111111111111111111
111111111111111111111111111111111111111111111111111111111111111111111111111111111111111111111111
111111111111111111111111111111111111111111111111111111111111111111111111111111111111111111111111
111111111111111111111111111111111111111111111111111111111111111111111111111111111111111111111111
111111111111111111111111111111111111111111111111111111111111111111111111111111111111111111111111
111111111111111111111111111111111111111111111111111111111111111111111111111111111111111111111111
111111111111111111111111111111111111111111111111111111111111111111111111111111111111111111111111
111111111111111111111111111111111111111111111111111111111111111111111111111111111111111111111111
111111111111111111111111111111111111111111111111111111111111111111111111111111111111111111111111
111111111111111111111111111111111111111111111111111111111111111111111111111111111111111111111111
111111111111111111111111111111111111111111111111111111111111111111111111111111111111111111111111
111111111111111111111111111111111111111111111111111111111111111111111111111111111111111111111111
111111111111111111111111111111111111111111111111111111111111111111111111111111111111111111111111
111111111111111111111111111111111111111111111111111111111111111111111111111111111111111111111111
111111111111111111111111111111111111111111111111111111111111111111111111111111111111111111111111
111111111111111111111111111111111111111111111111111111111111111111111111111111111111111111111111
111111111111111111111111111111111111111111111111111111111111111111111111111111111111111111111111
111111111111111111111111111111111111111111111111111111111111111111111111111111111111111111111111
111111111111111111111111111111111111111111111111111111111111111111111111111111111111111111111111
111111111111111111111111111111111111111111111111111111111111111111111111111111111111111111111111
111111111111111111111111111111111111111111111111111111111111111111111111111111111111111111111111
111111111111111111111111111111111111111111111111111111111111111111111111111111111111111111111111
111111111111111111111111111111111111111111111111111111111111111111111111111111111111111111111111
111111111111111111111111111111111111111111111111111111111111111111111111111111111111111111111111
111111111111111111111111111111111111111111111111111111111111111111111111111111111111111111111111
111111111111111111111111111111111111111111111111111111111111111111111111111111111111111111111111
111111111111111111111111111111111111111111111111111111111111111111111111111111111111111111111111
111111111111111111111111111111111111111111111111111111111111111111111111111111111111111111111111
111111111111111111111111111111111111111111111111111111111111111111111111111111111111111111111111
111111111111111111111111111111111111111111111111111111111111111111111111111111111111111111111111
111111111111111111111111111111111111111111111111111111111111111111111111111111111111111111111111
111111111111111111111111111111111111111111111111111111111111111111111111111111111111111111111111
111111111111111111111111111111111111111111111111111111111111111111111111111111111111111111111111
111111111111111111111111111111111111111111111111111111111111111111111111111111111111111111111111
111111111111111111111111111111111111111111111111111111111111111111111111111111111111111111111111
111111111111111111111111111111111111111111111111111111111111111111111111111111111111111111111111
111111111111111111111111111111111111111111111111111111111111111111111111111111111111111111111111
111111111111111111111111111111111111111111111111111111111111111111111111111111111111111111111111
111111111111111111111111111111111111111111111111111111111111111111111111111111111111111111111111
111111111111111111111111111111111111111111111111111111111111111111111111111111111111111111111111
111111111111111111111111111111111111111111111111111111111111111111111111111111111111111111111111
111111111111111111111111111111111111111111111111111111111111111111111111111111111111111111111111
111111111111111111111111111111111111111111111111111111111111111111111111111111111111111111111111
111111111111111111111111111111111111111111111111111111111111111111111111111111111111111111111111
111111111111111111111111111111111111111111111111111111111111111111111111111111111111111111111111
111111111111111111111111111111111111111111111111111111111111111111111111111111111111111111111111
111111111111111111111111111111111111111111111111111111111111111111111111111111111111111111111111
111111111111111111111111111111111111111111111111111111111111111111111111111111111111111111111111
111111111111111111111111111111111111111111111111111111111111111111111111111111111111111111111111
111111111111111111111111111111111111111111111111111111111111111111111111111111111111111111111111
111111111111111111111111111111111111111111111111111111111111111111111111111111111111111111111111
111111111111111111111111111111111111111111111111111111111111111111111111111111111111111111111111
111111111111111111111111111111111111111111111111111111111111111111111111111111111111111111111111
