1111111111111111111111111111
0000000001000000001000000001
-1000000001000000001000000001
0000000001000000001000000001
1111100001111100001000000001
1000100000000000001000100001
1000100000000000000000100001
1000100000000000000000100001
1000100000000000000000100001
1000011110000011111111100001
1000000000000000001000000001
1000000000000000001000000001
1000000000000000001000000001
1111111111111111111000111111
1000000000000100000000111111
1000000000000100000000111111
1000000000000100000000111111
1000000000000100000000111111
1000111110000000011111111111
1000100000000000010111111111
1000100000000000010111111111
1000100000000000010111111111
1000111110000000010111111111
1000000010000000000111111111
1000000010000000000011111111
1000000010000100000001111111
111100-2010000000000000111111
1101000011111111111111111111
