111111111111111111111111111
000000000100000000100000000
-100000000100000000100000000
000000000100000000100000000
111110000111110000100000000
100010000111110000100010000
100010000000000000000010000
100010000000000000000010000
100010000000000000000010000
100001111000001111111110001
100000000000000000100000001
100000000000000000100000001
100000000000000000100000001
111111111111111111100000001
100000000000010011000011111
100000000000010000000011111
100000000000010000000011111
000011000000010000000011111
100011111000000001111111111
000010000000000001111111111
000010000000000001111111111
000010000000000001111111111
000011111000000001111111111
000000001000000000011111111
000000001000000000001111111
000000001000000000000111111
111110-201000000000000011111
111111001111111111111111111
