11111111111111111111111111111
10000000001000000001000000001
-10000000001000000001000000001
10000000001000000001000000001
11111100001111100001000000001
11000100001111100001000100001
11000100000000000000000100001
11000100000000000000000100001
11000100000000000000000100001
11000011110000011111111100001
11000000000000000001000000001
11000000000000000001000000001
11000000000000000001000000011
11111111111111111111000000011
11000000000000100110000111111
11000000000000100000000111111
11000000000000100000000111111
11000000000000100000000111111
11000111110000000011111111111
11000100000000000011111111111
11000100000000000011111111111
11000100000000000011111111111
11000111110000000011111111111
11000000010000000000111111111
11000000010000000000011111111
10000000010000000000001111111
111110-20010000000000000111111
11101000011111111111111111111
