1111111111111111111111111111
-1000000000100000000100000000
1000000000100000000100000000
1000000000100000000100000000
1111110000111110000100000000
1100010000000110000100010001
1100010000000000000000010000
1100010000000000000000010000
1100010000000000000000010000
1100001111000001111111110000
1100000000000000000100000001
1100000000000000000100000001
1100000000000000000100000001
1111111111111111111100011111
1100000000000010000000011111
1100000000000010000000011111
1100000000000010000000011111
1100001000000010000000011111
1100011111000000001111111111
1100010000000000001111111111
1100010000000000001111111111
1100010000000000001111111111
0100011111000000001111111111
1100000001000000000011111111
1100000001000000000001111111
10000-20001000000000000111111
1111100001000000000000011111
1111111001111111111111111111
